la_der_des_der
carte1.lvl
tiles.png
9 4 31
11 15
19 20 21
21 21 21 21 21 21 21 21 21 21 21 21 21 21 21
21 22 22 22 22 22 22 22 22 22 22 22 22 22 21
21 18 21 18 21 20 21 18 21 20 21 20 21 18 21
21 18 22 18 22 18 22 18 22 18 22 18 20 18 21
21 18 21 18 21 18 21 20 21 18 21 18 21 18 21
21 18 22 18 20 18 20 20 20 18 20 18 22 18 21
21 18 21 18 21 18 21 20 21 18 21 18 21 18 21
21 18 20 18 22 18 22 18 22 18 22 18 22 18 21
21 18 21 20 21 20 21 18 21 20 21 20 21 18 21
21 18 22 18 22 18 22 18 22 18 22 18 22 18 21
21 21 21 21 21 21 21 21 21 21 21 21 21 21 21