la_desolation_du_moine
carte2.lvl
tiles.png
9 4 31
11 15
19 20 21
21 21 21 21 21 21 21 21 21 21 21 21 21 21 21
21 22 22 22 22 22 22 22 22 22 22 22 22 22 21
21 18 21 18 21 20 21 18 21 20 21 18 18 18 21
21 18 22 18 22 18 22 18 22 18 22 18 18 18 21
21 18 21 18 21 18 21 20 21 18 21 18 21 18 21
21 18 18 18 20 18 20 20 20 18 20 18 20 18 21
21 18 18 18 21 18 21 20 18 18 21 18 21 18 21
21 18 18 18 22 18 22 18 18 18 22 18 20 18 21
21 18 18 20 21 20 21 18 21 18 21 20 21 18 21
21 18 18 18 22 18 22 18 22 18 22 18 22 18 21
21 21 21 21 21 21 21 21 21 21 21 21 21 21 21